wiersze = 5
kolumny = 7

Wygenerowana mapa:
6 0 0 0 9 0 0 
0 0 9 9 0 0 9 
0 0 6 0 0 0 0 
0 0 9 0 0 0 0 
0 9 0 1 0 9 2 
