wiersze = 5
kolumny = 7

Wygenerowana mapa:
0 0 0 0 0 0 9 
0 0 2 6 1 0 0 
9 9 0 0 0 9 0 
9 9 0 0 0 0 0 
0 0 9 0 0 0 0 
