wiersze = 5
kolumny = 7

Wygenerowana mapa:
9 0 9 0 9 9 0 
0 0 0 0 0 0 0 
0 0 0 0 0 0 0 
9 0 0 6 0 0 0 
9 0 9 0 2 0 1 
